40,40,40,40,40,40,40,40,40,40,40,40,40,40,40,40,40,40,40,40,40,40,40,40,40,40,40,40,40,40
40,48,48,48,48,48,48,48,48,48,48,48,48,48,48,48,48,48,48,48,48,48,48,48,48,48,48,48,48,40
40,48,48,48,48,48,48,48,48,48,48,48,48,48,48,48,48,48,48,48,48,48,48,48,48,48,48,48,48,40
40,48,48,48,48,48,48,48,48,48,48,48,48,48,48,48,48,48,48,48,48,48,48,48,48,48,48,48,48,40
40,48,48,48,48,48,48,48,48,48,48,48,48,48,48,48,48,48,48,48,48,48,48,48,48,48,48,48,48,40
40,48,48,48,48,48,48,48,48,40,40,40,40,40,40,40,40,40,40,40,48,48,48,48,48,48,48,48,48,40
40,48,48,48,48,48,48,48,48,40,40,40,40,40,40,40,40,40,40,40,48,48,48,48,48,48,48,48,48,40
40,48,48,48,48,48,48,48,48,40,40,48,48,48,48,48,48,48,40,40,48,48,48,48,48,48,48,48,48,40
40,48,48,48,48,48,48,48,48,40,40,48,48,48,48,48,48,48,40,40,48,48,48,48,48,48,48,48,48,40
40,48,48,48,48,48,48,48,48,40,40,48,48,48,48,48,48,48,40,40,48,48,48,48,48,48,48,48,48,40
40,48,48,48,48,48,48,48,48,40,40,48,48,48,48,48,48,48,40,40,48,48,48,48,48,48,48,48,48,40
40,48,48,48,48,48,48,48,48,40,40,48,48,48,48,48,48,48,40,40,48,48,48,48,48,48,48,48,48,40
40,48,48,48,48,48,48,48,48,40,40,48,48,48,48,48,48,48,40,40,48,48,48,48,48,48,48,48,48,40
40,48,48,48,48,48,48,48,48,48,48,48,48,48,48,48,48,48,48,48,48,48,48,48,48,48,48,48,48,40
40,48,48,48,48,48,48,48,48,48,48,48,48,48,48,48,48,48,48,48,48,48,48,48,48,48,48,48,48,40
40,48,48,48,48,48,48,48,48,48,48,48,48,48,48,48,48,48,48,48,48,48,48,48,48,48,48,48,48,40
40,48,48,48,48,48,48,48,48,48,48,48,48,48,48,48,48,48,48,48,48,48,48,48,48,48,48,48,48,40
40,48,48,48,48,48,48,48,48,48,48,48,48,48,48,48,48,48,48,48,48,48,48,48,48,48,48,48,48,40
40,48,48,48,48,48,48,48,48,48,48,48,48,48,48,48,48,48,48,48,48,48,48,48,48,48,48,48,48,40
40,40,40,40,40,40,40,40,40,40,40,40,40,40,40,40,40,40,40,40,40,40,40,40,40,40,40,40,40,40
